trial_id,start_ms,duration_ms,fix_x,fix_y,exp_id,end_ms,program
8,250,184,423.4375,378.083343505859,0,434,rectangle
8,567,200,324.711547851563,67.538459777832,0,767,rectangle
8,867,183,415.625,-3.75,0,1050,rectangle
8,1284,283,444.852935791016,159.11764526367202,0,1567,rectangle
8,2034,867,366.03079223632795,133.84289550781298,0,2901,rectangle
8,2951,317,469.0625,143.449996948242,0,3268,rectangle
8,3352,233,397.5,210.0,0,3585,rectangle
8,3785,183,619.6875,221.5,0,3968,rectangle
8,4102,383,782.34375,205.875,0,4485,rectangle
8,4552,433,416.574066162109,275.481475830078,0,4985,rectangle
8,5619,317,405.0625,322.70001220703097,0,5936,rectangle
8,5953,466,424.91378784179705,295.82757568359403,0,6419,rectangle
8,6470,350,378.97726440429705,496.909088134766,0,6820,rectangle
8,7103,167,632.045471191406,513.181823730469,0,7270,rectangle
8,7287,233,574.75,515.333312988281,0,7520,rectangle
8,7537,166,670.340881347656,523.727294921875,0,7703,rectangle
8,12822,200,492.5,774.3076782226559,0,13022,rectangle
8,13106,200,580.096130371094,771.1538696289059,0,13306,rectangle
8,13356,150,783.75,775.2000122070309,0,13506,rectangle
8,13539,434,884.305541992188,778.5925903320309,0,13973,rectangle
8,14006,250,591.25,782.375,0,14256,rectangle
8,14706,451,494.73214721679705,783.2142944335941,0,15157,rectangle
8,15240,167,427.159088134766,769.272705078125,0,15407,rectangle
8,15457,233,497.916656494141,837.599975585938,0,15690,rectangle
8,16024,166,660.454528808594,770.636352539063,0,16190,rectangle
8,16224,267,844.11767578125,779.7647094726559,0,16491,rectangle
8,16507,334,913.3928833007809,785.619018554688,0,16841,rectangle
8,17291,333,474.047607421875,819.619018554688,0,17624,rectangle
8,17975,300,677.5657958984381,815.368408203125,0,18275,rectangle
8,18291,184,703.125,826.5833129882809,0,18475,rectangle
8,18491,151,659.375,826.2999877929691,0,18642,rectangle
8,18675,267,685.0,890.6470336914059,0,18942,rectangle
8,19125,384,659.479187011719,814.0416870117191,0,19509,rectangle
8,20059,233,569.166687011719,489.266662597656,0,20292,rectangle
8,20325,217,465.89285278320295,371.714294433594,0,20542,rectangle
8,20576,250,445.78125,227.375,0,20826,rectangle
8,20909,200,362.5,234.307693481445,0,21109,rectangle
8,21159,234,387.666656494141,169.13333129882798,0,21393,rectangle
8,21759,217,578.9285888671881,521.4285888671881,0,21976,rectangle
8,22410,167,441.70455932617205,599.909118652344,0,22577,rectangle
8,22593,184,468.020843505859,666.333312988281,0,22777,rectangle
8,22793,184,414.270843505859,658.833312988281,0,22977,rectangle
8,23010,267,627.941162109375,660.0,0,23277,rectangle
8,23327,300,710.131591796875,671.421081542969,0,23627,rectangle
8,23660,717,845.9943237304691,676.8636474609381,0,24377,rectangle
8,24427,150,728.625,617.0999755859381,0,24577,rectangle
8,24627,334,645.0,598.714294433594,0,24961,rectangle
8,24978,400,685.299987792969,588.719970703125,0,25378,rectangle
8,25394,284,650.486083984375,548.777770996094,0,25678,rectangle
8,25695,200,653.269226074219,523.4615478515631,0,25895,rectangle
8,25911,334,694.880981445313,506.238098144531,0,26245,rectangle
8,26528,434,480.324066162109,275.59259033203097,0,26962,rectangle
8,26978,317,469.75,320.20001220703097,0,27295,rectangle
8,27312,283,479.097229003906,357.61111450195295,0,27595,rectangle
8,27612,350,433.068176269531,380.863647460938,0,27962,rectangle
8,27979,217,607.857116699219,516.5714111328131,0,28196,rectangle
8,28279,217,358.214294433594,338.0,0,28496,rectangle
8,28512,517,681.9921875,235.375,0,29029,rectangle
8,29296,217,804.1071166992191,824.7142944335941,0,29513,rectangle
8,29530,516,806.4453125,770.53125,0,30046,rectangle
8,30063,467,692.112060546875,788.586181640625,0,30530,rectangle
8,30547,500,648.3870849609381,808.6774291992191,0,31047,rectangle
8,31080,217,478.303558349609,815.0,0,31297,rectangle
8,31330,334,506.071441650391,475.428558349609,0,31664,rectangle
8,31914,300,481.973693847656,347.684204101563,0,32214,rectangle
8,32481,250,691.71875,637.5625,0,32731,rectangle
8,32748,266,723.529418945313,601.352966308594,0,33014,rectangle
8,33048,166,603.409118652344,579.3636474609381,0,33214,rectangle
8,33281,367,646.684753417969,519.434753417969,0,33648,rectangle
8,33665,317,691.4375,510.850006103516,0,33982,rectangle
8,34032,433,769.444458007813,515.407409667969,0,34465,rectangle
8,34482,200,675.769226074219,506.15383911132795,0,34682,rectangle
8,35065,234,486.083343505859,283.466674804688,0,35299,rectangle
8,35365,301,417.828948974609,261.421051025391,0,35666,rectangle
8,35699,200,487.40383911132795,203.538467407227,0,35899,rectangle
8,35982,167,542.159118652344,243.0,0,36149,rectangle
8,36166,166,651.931823730469,238.454544067383,0,36332,rectangle
8,36849,267,743.4558715820309,230.29411315918,0,37116,rectangle
8,37183,317,796.125,677.200012207031,0,37500,rectangle
8,37516,184,842.2916870117191,761.5,0,37700,rectangle
8,42969,200,769.038452148438,485.07693481445295,0,43169,rectangle
8,43219,400,658.6500244140631,498.95999145507795,0,43619,rectangle
8,43653,383,645.104187011719,215.83332824707,0,44036,rectangle
8,44086,250,582.265625,221.25,0,44336,rectangle
8,44369,234,484.166656494141,266.26666259765597,0,44603,rectangle
8,44719,417,442.259613037109,280.76922607421903,0,45136,rectangle
8,45420,216,574.8214111328131,240.928573608398,0,45636,rectangle
8,45653,267,455.147064208984,174.117645263672,0,45920,rectangle
8,45937,450,750.8928833007809,229.428573608398,0,46387,rectangle
8,46587,517,683.7109375,512.5625,0,47104,rectangle
8,47121,316,683.25,583.5999755859381,0,47437,rectangle
8,47487,300,737.434204101563,525.0,0,47787,rectangle
8,47821,250,419.0,382.600006103516,0,48071,rectangle
8,48088,200,672.692321777344,515.3846435546881,0,48288,rectangle
8,48321,434,780.138916015625,516.296325683594,0,48755,rectangle
8,49088,617,698.1578979492191,480.052642822266,0,49705,rectangle
8,49722,250,667.1875,511.5625,0,49972,rectangle
8,50005,217,662.3214111328131,242.428573608398,0,50222,rectangle
8,50739,150,761.5,227.800003051758,0,50889,rectangle
8,50922,284,702.361083984375,492.5,0,51206,rectangle
8,51222,200,677.7884521484381,500.92306518554705,0,51422,rectangle
8,51489,150,731.25,529.5999755859381,0,51639,rectangle
8,51889,267,600.955871582031,247.882354736328,0,52156,rectangle
8,52189,401,752.2000122070309,242.279998779297,0,52590,rectangle
8,52956,384,863.9583129882809,762.375,0,53340,rectangle
8,53607,166,757.386352539063,356.27273559570295,0,53773,rectangle
8,53807,350,749.8295288085941,525.272705078125,0,54157,rectangle
8,54190,484,735.7083129882809,237.533340454102,0,54674,rectangle
8,54707,284,733.194458007813,513.666687011719,0,54991,rectangle
8,55007,317,755.6875,533.049987792969,0,55324,rectangle
8,55708,216,835.446411132813,777.8571166992191,0,55924,rectangle
8,55958,150,903.0,791.900024414063,0,56108,rectangle
8,56391,200,665.769226074219,540.6153564453131,0,56591,rectangle
8,56608,167,670.227294921875,576.090881347656,0,56775,rectangle
8,56825,233,770.3333129882809,596.933349609375,0,57058,rectangle
8,57158,234,686.416687011719,599.4666748046881,0,57392,rectangle
8,57425,233,878.0833129882809,796.1333618164059,0,57658,rectangle
8,57725,167,696.7045288085941,301.81817626953097,0,57892,rectangle
8,57942,217,848.303588867188,739.7857055664059,0,58159,rectangle
8,58175,300,847.23681640625,768.26318359375,0,58475,rectangle
8,58509,150,715.25,441.600006103516,0,58659,rectangle
8,58809,433,677.5,572.370361328125,0,59242,rectangle
8,59259,167,683.6363525390631,523.3636474609381,0,59426,rectangle
8,59459,217,828.125,744.7142944335941,0,59676,rectangle
8,59859,334,947.4404907226559,796.047607421875,0,60193,rectangle
8,60210,766,933.1914672851559,777.127685546875,0,60976,rectangle
8,61193,267,705.5147094726559,632.294128417969,0,61460,rectangle
8,61477,250,687.5,607.5625,0,61727,rectangle
8,61760,317,914.75,786.150024414063,0,62077,rectangle
8,62094,150,841.875,771.2999877929691,0,62244,rectangle
8,62411,200,921.0576782226559,773.8461303710941,0,62611,rectangle
8,62627,267,670.808837890625,764.2941284179691,0,62894,rectangle
8,62911,150,692.375,782.5,0,63061,rectangle
8,63111,317,653.875,679.799987792969,0,63428,rectangle
8,63461,333,836.726196289063,786.428588867188,0,63794,rectangle
8,64095,216,916.071411132813,775.3571166992191,0,64311,rectangle
8,64345,433,709.7684936523441,647.518493652344,0,64778,rectangle
8,64795,183,689.5833129882809,584.25,0,64978,rectangle
8,65045,217,765.0,591.9285888671881,0,65262,rectangle
8,65278,267,595.808837890625,662.11767578125,0,65545,rectangle
8,65562,217,707.5892944335941,672.5,0,65779,rectangle
8,65829,300,820.3289184570309,670.6842041015631,0,66129,rectangle
8,66529,217,883.75,826.5,0,66746,rectangle
8,66779,233,581.166687011719,821.8666381835941,0,67012,rectangle
8,67029,517,683.1640625,816.34375,0,67546,rectangle
8,67629,5253,676.5,877.0,0,72882,rectangle
8,72898,351,657.329528808594,905.5454711914059,0,73249,rectangle
8,73265,234,653.083312988281,845.6666870117191,0,73499,rectangle
8,73532,250,-200.0,0.0,0,73782,rectangle
8,73832,167,779.4318237304691,849.0,0,73999,rectangle
8,74199,150,765.625,870.900024414063,0,74349,rectangle
8,74399,300,653.48681640625,645.789489746094,0,74699,rectangle
8,74899,217,-200.0,0.0,0,75116,rectangle
8,75183,383,712.1354370117191,728.8333129882809,0,75566,rectangle
8,75616,417,717.6923217773441,884.1923217773441,0,76033,rectangle
8,76050,166,670.340881347656,895.636352539063,0,76216,rectangle
8,76283,267,539.3382568359381,305.470581054688,0,76550,rectangle
8,76934,683,610.5059814453131,798.523803710938,0,77617,rectangle
8,77667,167,694.3181762695309,887.8181762695309,0,77834,rectangle
8,78017,184,771.25,821.8333129882809,0,78201,rectangle
8,78251,300,615.460510253906,662.789489746094,0,78551,rectangle
8,78601,150,687.375,613.799987792969,0,78751,rectangle
8,78918,233,734.0833129882809,570.933349609375,0,79151,rectangle
8,79168,233,724.3333129882809,535.666687011719,0,79401,rectangle
8,79418,617,680.1973876953131,527.421081542969,0,80035,rectangle
8,80068,200,799.8076782226559,761.923095703125,0,80268,rectangle
8,80385,283,742.7777709960941,509.722229003906,0,80668,rectangle
8,80735,200,834.711547851563,852.1538696289059,0,80935,rectangle
8,81102,317,868.4375,857.349975585938,0,81419,rectangle
8,81452,484,708.75,526.633361816406,0,81936,rectangle
8,81952,417,670.3846435546881,509.84616088867205,0,82369,rectangle
8,82653,183,883.8541870117191,856.9166870117191,0,82836,rectangle
8,82886,217,718.928588867188,548.0714111328131,0,83103,rectangle
8,83119,451,687.991088867188,515.035705566406,0,83570,rectangle
8,83603,233,888.25,880.066650390625,0,83836,rectangle
8,83987,283,732.1527709960941,508.38888549804705,0,84270,rectangle
8,84287,366,767.989135742188,529.869567871094,0,84653,rectangle
8,84920,234,773.75,852.8666381835941,0,85154,rectangle
8,85204,183,847.7083129882809,861.0,0,85387,rectangle
8,85454,683,669.732116699219,533.666687011719,0,86137,rectangle
8,86187,167,711.7045288085941,599.181823730469,0,86354,rectangle
8,86421,250,786.71875,671.0,0,86671,rectangle
8,86721,283,849.7222290039059,680.611083984375,0,87004,rectangle
8,87288,250,649.375,686.625,0,87538,rectangle
8,87571,384,716.3020629882809,675.5,0,87955,rectangle
8,88005,183,697.8125,604.166687011719,0,88188,rectangle
8,88355,167,400.681823730469,571.0,0,88522,rectangle
8,88539,316,440.5,575.0,0,88855,rectangle
8,88889,200,778.9423217773441,675.230773925781,0,89089,rectangle
8,89139,166,696.7045288085941,676.6363525390631,0,89305,rectangle
8,89322,150,568.75,669.9000244140631,0,89472,rectangle
8,89506,400,481.149993896484,659.5999755859381,0,89906,rectangle
8,90056,217,684.732116699219,892.0,0,90273,rectangle
8,90439,200,707.4038696289059,786.7692260742191,0,90639,rectangle
8,90789,1001,869.5901489257809,788.836059570313,0,91790,rectangle
8,91807,383,818.3333129882809,790.1666870117191,0,92190,rectangle
8,92224,233,912.1666870117191,798.6666870117191,0,92457,rectangle
8,92490,167,889.0908813476559,861.0,0,92657,rectangle
9,250,200,407.5,218.92308044433602,1,450,rectangle
9,500,450,386.29464721679705,106.571426391602,1,950,rectangle
9,966,167,344.77273559570295,94.09091186523442,1,1133,rectangle
9,1200,167,-190.0,0.0,1,1367,rectangle
9,1433,250,416.796875,46.25,1,1683,rectangle
9,2067,167,254.204544067383,5.72727251052856,1,2234,rectangle
9,2284,367,438.011352539063,66.0454559326172,1,2651,rectangle
9,2801,183,495.208343505859,72.75,1,2984,rectangle
9,3284,150,476.875,131.0,1,3434,rectangle
9,3451,150,431.125,129.199996948242,1,3601,rectangle
9,3851,234,472.916656494141,235.199996948242,1,4085,rectangle
9,4151,167,563.75,168.545455932617,1,4318,rectangle
9,4785,300,436.973693847656,237.947372436523,1,5085,rectangle
9,5168,251,492.890625,301.125,1,5419,rectangle
9,5469,200,467.019226074219,211.153839111328,1,5669,rectangle
9,5769,150,509.0,230.800003051758,1,5919,rectangle
9,5935,267,491.029418945313,255.823532104492,1,6202,rectangle
9,6219,217,462.053558349609,259.21429443359403,1,6436,rectangle
9,6486,483,512.583312988281,278.966674804688,1,6969,rectangle
9,6986,150,486.375,313.70001220703097,1,7136,rectangle
9,7286,200,420.865386962891,445.92306518554705,1,7486,rectangle
9,7603,167,458.409088134766,452.818176269531,1,7770,rectangle
9,7886,284,370.902770996094,456.88888549804705,1,8170,rectangle
9,8186,167,446.47726440429705,465.54544067382795,1,8353,rectangle
9,8403,300,584.671081542969,464.842102050781,1,8703,rectangle
9,8737,650,682.2115478515631,466.205139160156,1,9387,rectangle
9,9520,184,742.6041870117191,456.583343505859,1,9704,rectangle
9,9787,167,792.5,448.27273559570295,1,9954,rectangle
9,10171,216,554.1964111328131,463.214294433594,1,10387,rectangle
9,10471,283,423.541656494141,463.833343505859,1,10754,rectangle
9,10938,350,652.6136474609381,465.54544067382795,1,11288,rectangle
9,11304,567,691.8571166992191,459.314300537109,1,11871,rectangle
9,11905,183,507.083343505859,279.0,1,12088,rectangle
9,12121,884,747.129638671875,445.703704833984,1,13005,rectangle
9,13022,167,775.7954711914059,443.909088134766,1,13189,rectangle
9,13255,500,681.3709716796881,463.645172119141,1,13755,rectangle
9,13789,150,574.5,249.899993896484,1,13939,rectangle
9,13956,283,506.180541992188,242.277770996094,1,14239,rectangle
9,14256,233,493.166656494141,291.399993896484,1,14489,rectangle
9,14556,267,764.7058715820309,531.4117431640631,1,14823,rectangle
9,14873,316,701.4375,538.799987792969,1,15189,rectangle
9,15206,167,751.25,534.818176269531,1,15373,rectangle
9,15423,183,417.5,542.25,1,15606,rectangle
9,15840,333,440.238098144531,633.952392578125,1,16173,rectangle
9,16190,150,501.0,633.5,1,16340,rectangle
9,16423,167,407.159088134766,633.3636474609381,1,16590,rectangle
9,16623,184,308.333343505859,636.416687011719,1,16807,rectangle
9,17007,400,521.9000244140631,641.960021972656,1,17407,rectangle
9,17440,150,579.875,646.299987792969,1,17590,rectangle
9,17974,333,434.64285278320295,648.3809814453131,1,18307,rectangle
9,18374,234,508.416656494141,640.799987792969,1,18608,rectangle
9,18641,367,623.6956787109381,646.478271484375,1,19008,rectangle
9,19058,183,773.9583129882809,633.0,1,19241,rectangle
9,19308,250,887.109375,617.8125,1,19558,rectangle
9,19608,233,661.833312988281,635.4000244140631,1,19841,rectangle
9,20058,184,367.708343505859,725.5,1,20242,rectangle
9,20275,333,492.321441650391,728.2380981445309,1,20608,rectangle
9,20708,150,550.25,755.900024414063,1,20858,rectangle
9,20875,434,587.5,766.5925903320309,1,21309,rectangle
9,21525,334,509.523803710938,798.7619018554691,1,21859,rectangle
9,21909,250,633.90625,803.0,1,22159,rectangle
9,22276,150,707.125,809.400024414063,1,22426,rectangle
9,22476,250,575.9375,772.4375,1,22726,rectangle
9,22776,317,490.375,748.2000122070309,1,23093,rectangle
9,23243,200,650.3846435546881,754.6923217773441,1,23443,rectangle
9,23476,217,472.410705566406,743.3571166992191,1,23693,rectangle
9,23910,150,521.125,776.7999877929691,1,24060,rectangle
9,24093,334,673.2738037109381,767.619018554688,1,24427,rectangle
9,24460,267,842.7941284179691,759.11767578125,1,24727,rectangle
9,24877,150,921.25,761.7999877929691,1,25027,rectangle
9,25177,300,819.2763061523441,779.315795898438,1,25477,rectangle
9,25560,317,696.1875,761.0499877929691,1,25877,rectangle
9,26078,150,559.875,226.399993896484,1,26228,rectangle
9,26411,167,663.181823730469,201.72727966308602,1,26578,rectangle
9,26628,283,609.3055419921881,190.555557250977,1,26911,rectangle
9,26928,200,634.6153564453131,194.07691955566398,1,27128,rectangle
9,27245,283,554.097229003906,200.444442749023,1,27528,rectangle
9,27611,150,470.25,233.399993896484,1,27761,rectangle
9,27778,834,463.161773681641,256.313720703125,1,28612,rectangle
9,29812,217,513.5714111328131,375.428558349609,1,30029,rectangle
9,30079,334,469.464294433594,330.619049072266,1,30413,rectangle
9,30796,334,718.75,204.904754638672,1,31130,rectangle
9,31196,200,788.8461303710941,218.153839111328,1,31396,rectangle
9,31447,266,466.544128417969,315.470581054688,1,31713,rectangle
9,31730,600,462.466217041016,290.243255615234,1,32330,rectangle
9,32730,451,825.625,172.357147216797,1,33181,rectangle
9,33214,434,645.879638671875,186.592590332031,1,33648,rectangle
9,33681,483,592.541687011719,187.5,1,34164,rectangle
9,34181,183,649.479187011719,187.66667175293,1,34364,rectangle
9,34831,334,927.2619018554691,758.7142944335941,1,35165,rectangle
9,35398,167,693.0681762695309,830.5454711914059,1,35565,rectangle
9,35615,167,438.52273559570295,816.9091186523441,1,35782,rectangle
9,35882,283,624.722229003906,814.8333129882809,1,36165,rectangle
9,36182,150,662.75,813.5,1,36332,rectangle
9,36365,234,720.0833129882809,805.933349609375,1,36599,rectangle
9,36615,417,670.2884521484381,806.384643554688,1,37032,rectangle
9,37299,183,600.104187011719,814.1666870117191,1,37482,rectangle
9,37549,384,664.21875,817.3333129882809,1,37933,rectangle
9,38199,317,549.125,814.349975585938,1,38516,rectangle
9,38550,266,626.691162109375,819.588256835938,1,38816,rectangle
9,38866,651,691.96875,815.7999877929691,1,39517,rectangle
9,39583,300,675.131591796875,885.4210815429691,1,39883,rectangle
9,39933,384,659.166687011719,813.2916870117191,1,40317,rectangle
9,40384,183,670.3125,749.9166870117191,1,40567,rectangle
9,40584,200,617.7884521484381,768.6923217773441,1,40784,rectangle
9,40834,183,554.895812988281,773.0833129882809,1,41017,rectangle
9,41034,183,557.5,848.9166870117191,1,41217,rectangle
9,41251,350,852.3295288085941,851.636352539063,1,41601,rectangle
9,41651,217,715.178588867188,851.3571166992191,1,41868,rectangle
9,41934,217,693.6607055664059,815.8571166992191,1,42151,rectangle
9,42284,334,671.1309814453131,824.90478515625,1,42618,rectangle
9,42635,267,638.014709472656,821.1764526367191,1,42902,rectangle
9,42951,217,678.214294433594,822.2142944335941,1,43168,rectangle
9,43235,200,851.7307739257809,767.8461303710941,1,43435,rectangle
9,43535,250,914.609375,772.25,1,43785,rectangle
9,44085,217,832.4107055664059,750.8571166992191,1,44302,rectangle
9,44435,451,695.0446166992191,808.5,1,44886,rectangle
9,45036,250,660.46875,549.0,1,45286,rectangle
9,45469,167,664.772705078125,433.27273559570295,1,45636,rectangle
9,45719,167,905.7954711914059,640.090881347656,1,45886,rectangle
9,45919,267,680.36767578125,636.4117431640631,1,46186,rectangle
9,46236,250,760.9375,626.375,1,46486,rectangle
9,46603,250,697.65625,634.625,1,46853,rectangle
9,46870,333,647.875,637.950012207031,1,47203,rectangle
9,47237,366,770.8695678710941,633.869567871094,1,47603,rectangle
9,47654,233,865.5,623.5333251953131,1,47887,rectangle
9,47970,467,921.594848632813,620.0,1,48437,rectangle
9,48487,284,884.6527709960941,797.6666870117191,1,48771,rectangle
9,48837,567,872.9642944335941,835.028564453125,1,49404,rectangle
9,49471,250,783.75,803.9375,1,49721,rectangle
9,49738,317,832.0,839.099975585938,1,50055,rectangle
9,50121,250,890.9375,850.75,1,50371,rectangle
9,50588,400,768.75,769.2000122070309,1,50988,rectangle
9,51388,200,850.865356445313,854.076904296875,1,51588,rectangle
9,51622,283,932.7777709960941,859.611083984375,1,51905,rectangle
9,51989,417,710.673095703125,746.615356445313,1,52406,rectangle
9,52422,217,844.375,859.428588867188,1,52639,rectangle
9,52656,583,923.4558715820309,871.441162109375,1,53239,rectangle
9,53256,400,901.2000122070309,887.4400024414059,1,53656,rectangle
9,53706,400,985.9500122070309,873.0800170898441,1,54106,rectangle
9,54190,183,1060.41662597656,849.6666870117191,1,54373,rectangle
9,54456,234,781.75,874.8666381835941,1,54690,rectangle
9,54757,433,746.5277709960941,903.9629516601559,1,55190,rectangle
9,55207,217,704.6428833007809,893.428588867188,1,55424,rectangle
9,55440,434,524.0740966796881,892.2963256835941,1,55874,rectangle
9,55907,317,641.0,883.0499877929691,1,56224,rectangle
9,56307,167,595.227294921875,860.727294921875,1,56474,rectangle
10,5102,167,473.06817626953125,14.0,2,5269,basketball
10,5419,217,544.9107055664064,79.64286041259766,2,5636,basketball
10,6136,267,427.058837890625,70.35294342041016,2,6403,basketball
10,6503,300,510.3947448730469,72.78947448730467,2,6803,basketball
10,6936,517,562.3828125,81.125,2,7453,basketball
10,7837,250,427.03125,44.6875,2,8087,basketball
10,8104,266,386.1764831542969,52.70588302612305,2,8370,basketball
10,8620,217,590.2678833007812,75.21428680419923,2,8837,basketball
10,8871,550,460.4779357910156,139.14706420898438,2,9421,basketball
10,9437,267,418.45587158203125,131.64706420898438,2,9704,basketball
10,9754,251,624.296875,150.875,2,10005,basketball
10,10038,233,869.5,158.93333435058594,2,10271,basketball
10,10621,267,482.3529357910156,196.82353210449216,2,10888,basketball
10,10905,234,425.9166564941406,210.0666656494141,2,11139,basketball
10,11155,300,574.5394897460938,208.7894744873047,2,11455,basketball
10,11672,267,431.1764831542969,164.8235321044922,2,11939,basketball
10,12089,216,418.94232177734375,189.61538696289062,2,12305,basketball
10,12339,233,424.75,52.599998474121094,2,12572,basketball
10,12656,216,375.44644165039057,-20.928571701049805,2,12872,basketball
10,12939,150,470.75,269.10000610351557,2,13089,basketball
10,13123,266,603.6029663085938,305.5882263183594,2,13389,basketball
10,13406,450,729.9553833007811,318.8928527832031,2,13856,basketball
10,13990,283,504.2361145019531,345.3333435058594,2,14273,basketball
10,14473,233,551.9166870117189,356.3999938964844,2,14706,basketball
10,14740,400,420.6499938964844,344.2799987792969,2,15140,basketball
10,15157,567,390.8571472167969,340.6571350097656,2,15724,basketball
10,15790,334,643.6309814453125,351.71429443359375,2,16124,basketball
10,16140,334,610.4761962890625,349.76190185546875,2,16474,basketball
10,16524,317,663.4375,340.8999938964844,2,16841,basketball
10,16874,300,790.8552856445312,356.3157958984375,2,17174,basketball
10,17191,150,767.5,357.6000061035156,2,17341,basketball
10,17358,166,655.5681762695312,355.0,2,17524,basketball
10,17558,166,740.7954711914062,347.0,2,17724,basketball
10,17758,567,466.2857055664063,356.028564453125,2,18325,basketball
10,18491,267,744.4852905273436,356.941162109375,2,18758,basketball
10,18825,300,696.6447143554688,343.52630615234375,2,19125,basketball
10,19142,216,781.7857055664062,321.21429443359375,2,19358,basketball
10,19425,217,716.1607055664064,305.21429443359375,2,19642,basketball
10,19792,184,771.7708129882812,320.0,2,19976,basketball
10,20259,167,563.8636474609375,357.0909118652344,2,20426,basketball
10,20576,183,614.4318237304688,301.9090881347656,2,20759,basketball
10,20776,300,582.1052856445312,337.84210205078125,2,21076,basketball
10,21093,350,604.8863525390625,351.2272644042969,2,21443,basketball
10,21493,333,500.5357055664063,345.3333435058594,2,21826,basketball
10,22360,200,442.59616088867193,170.76922607421875,2,22560,basketball
10,22593,500,468.75,343.6451721191406,2,23093,basketball
10,23444,183,711.4583129882812,323.75,2,23627,basketball
10,23710,200,455.6730651855469,69.38461303710939,2,23910,basketball
10,23927,184,399.5833435058594,68.16666412353516,2,24111,basketball
10,24344,167,480.9090881347656,16.636363983154293,2,24511,basketball
10,24561,150,537.875,335.29998779296875,2,24711,basketball
10,24728,266,577.5,335.1176452636719,2,24994,basketball
10,25011,317,468.0,384.7999877929688,2,25328,basketball
10,25361,317,482.75,616.5,2,25678,basketball
10,25745,366,562.0108642578125,489.3912963867188,2,26111,basketball
10,26412,200,393.36538696289057,758.4615478515625,2,26612,basketball
10,26645,467,510.77584838867193,763.4483032226561,2,27112,basketball
10,27129,183,634.5833129882812,765.0,2,27312,basketball
10,27329,150,-200.0,0.0,2,27479,basketball
10,27529,450,569.1517944335938,786.5714111328125,2,27979,basketball
10,28012,267,478.8970642089844,818.88232421875,2,28279,basketball
10,28296,250,439.609375,931.0,2,28546,basketball
10,28896,533,463.1060485839844,343.69696044921875,2,29429,basketball
10,29746,5420,403.69049072265625,349.71429443359375,2,35166,basketball
10,35382,367,513.5325927734375,403.1304321289063,2,35749,basketball
10,35766,667,467.256103515625,389.7317199707031,2,36433,basketball
10,36450,433,589.7222290039064,398.48147583007807,2,36883,basketball
10,36949,251,306.5833435058594,259.60000610351557,2,37200,basketball
10,37216,717,622.5283813476562,403.8409118652344,2,37933,basketball
10,37950,267,574.63232421875,393.4705810546875,2,38217,basketball
10,38233,184,474.5833435058594,392.3333435058594,2,38417,basketball
10,38450,183,704.8958129882812,188.25,2,38633,basketball
10,38700,334,489.047607421875,182.1904754638672,2,39034,basketball
10,39084,300,585.98681640625,185.26315307617188,2,39384,basketball
10,39734,217,431.07144165039057,361.7857055664063,2,39951,basketball
10,39967,717,471.5340881347656,391.5227355957031,2,40684,basketball
10,40868,283,546.1805419921875,437.77777099609375,2,41151,basketball
10,41168,167,617.1591186523438,440.2727355957031,2,41335,basketball
10,41351,167,565.6818237304688,434.0,2,41518,basketball
10,41652,200,480.7692260742188,368.4615478515625,2,41852,basketball
10,42135,217,525.5357055664064,647.0,2,42352,basketball
10,42402,167,451.25,765.727294921875,2,42569,basketball
10,42719,416,527.1634521484375,757.8461303710938,2,43135,basketball
10,43169,167,586.7045288085938,753.1818237304686,2,43336,basketball
10,43352,150,634.625,755.7000122070312,2,43502,basketball
10,43619,183,494.6875,511.1666564941406,2,43802,basketball
10,43903,166,517.5,444.6363525390625,2,44069,basketball
10,44086,167,568.1818237304688,438.3636474609375,2,44253,basketball
10,44269,184,600.625,432.4166564941406,2,44453,basketball
10,44469,367,467.9891357421875,434.8260803222656,2,44836,basketball
10,44903,250,523.828125,403.375,2,45153,basketball
10,45170,283,527.638916015625,490.1666564941406,2,45453,basketball
10,45770,267,468.6029357910156,808.6470336914062,2,46037,basketball
10,46053,184,436.4583435058594,793.8333129882812,2,46237,basketball
10,46254,316,541.4375,791.7000122070312,2,46570,basketball
10,46604,300,706.1842041015625,792.5263061523436,2,46904,basketball
10,46920,534,547.65625,657.84375,2,47454,basketball
10,47471,200,666.3461303710938,790.0,2,47671,basketball
10,47688,233,624.25,769.2000122070312,2,47921,basketball
10,48221,200,526.7307739257812,447.0769348144531,2,48421,basketball
10,48438,167,520.6818237304689,411.3636474609375,2,48605,basketball
10,48671,550,614.8897094726562,405.8529357910156,2,49221,basketball
10,49238,200,647.8846435546875,403.9230651855469,2,49438,basketball
10,49455,217,587.4107055664064,400.4285583496094,2,49672,basketball
10,49722,266,606.7647094726562,769.2941284179686,2,49988,basketball
10,50005,150,645.625,768.2000122070312,2,50155,basketball
10,50172,317,516.6875,756.1500244140625,2,50489,basketball
10,50539,300,542.9605102539064,392.26315307617193,2,50839,basketball
10,50855,167,542.272705078125,417.7272644042969,2,51022,basketball
10,51072,300,625.3289184570312,431.368408203125,2,51372,basketball
10,51422,317,541.125,414.3999938964844,2,51739,basketball
10,51773,316,657.875,776.8499755859375,2,52089,basketball
10,52123,317,739.75,793.7999877929686,2,52440,basketball
10,52556,317,552.3125,248.6499938964844,2,52873,basketball
10,52906,301,608.3552856445312,198.42105102539062,2,53207,basketball
10,53307,216,701.1607055664064,815.7857055664062,2,53523,basketball
10,53824,200,569.2307739257812,790.4615478515625,2,54024,basketball
10,54040,184,680.3125,790.0,2,54224,basketball
10,54274,350,761.022705078125,798.8181762695312,2,54624,basketball
10,54657,200,563.75,795.3846435546875,2,54857,basketball
10,55374,234,955.9166870117188,192.3999938964844,2,55608,basketball
10,55674,200,580.7692260742188,733.7692260742188,2,55874,basketball
10,55908,150,559.875,526.0,2,56058,basketball
10,56074,251,541.171875,462.375,2,56325,basketball
10,56341,300,432.76315307617193,414.2105407714844,2,56641,basketball
10,56791,217,345.0,337.8571472167969,2,57008,basketball
10,57092,150,448.25,426.0,2,57242,basketball
10,57275,284,493.5416564941406,469.5555419921875,2,57559,basketball
10,57609,200,416.6346130371094,393.30767822265625,2,57809,basketball
10,57892,300,569.6710815429688,473.73684692382807,2,58192,basketball
10,58209,350,337.8977355957031,396.81817626953125,2,58559,basketball
10,58576,233,619.0,505.6666564941406,2,58809,basketball
10,59159,384,458.59375,493.2916564941406,2,59543,basketball
10,59743,183,498.75,468.25,2,59926,basketball
10,65095,167,677.6136474609375,474.1818237304688,2,65262,basketball
10,65362,484,726.2916870117188,508.9666748046875,2,65846,basketball
10,65862,167,558.6363525390625,512.6363525390625,2,66029,basketball
10,66196,233,523.5,547.4000244140625,2,66429,basketball
10,66479,300,583.9473876953125,544.8421020507812,2,66779,basketball
10,66946,217,719.0178833007812,514.5,2,67163,basketball
10,67179,234,560.6666870117189,514.5333251953125,2,67413,basketball
10,67730,183,562.7083129882812,490.5833435058594,2,67913,basketball
10,67930,200,603.076904296875,503.61538696289057,2,68130,basketball
10,68163,217,581.4285888671875,428.8571472167969,2,68380,basketball
10,68413,200,482.30767822265625,406.5384521484375,2,68613,basketball
10,68630,350,501.1363525390625,370.0,2,68980,basketball
10,69230,267,520.808837890625,360.5882263183594,2,69497,basketball
10,69514,167,562.0454711914064,368.45455932617193,2,69681,basketball
10,69697,467,592.8016967773438,488.0689697265625,2,70164,basketball
10,70197,417,528.8461303710938,375.3846130371094,2,70614,basketball
10,70764,167,436.25,362.1818237304688,2,70931,basketball
10,71314,301,386.51315307617193,75.63157653808595,2,71615,basketball
10,72015,267,593.2352905273438,506.6470642089844,2,72282,basketball
10,72298,250,723.203125,514.875,2,72548,basketball
10,72565,367,689.3478393554688,503.6956481933594,2,72932,basketball
10,72948,300,266.5131530761719,319.0526428222656,2,73248,basketball
10,73265,284,600.625,480.3333435058594,2,73549,basketball
10,73582,183,676.7708129882812,485.25,2,73765,basketball
10,73882,250,734.6875,499.75,2,74132,basketball
10,74182,184,563.8541870117188,495.4166564941406,2,74366,basketball
10,74382,567,521.6785888671875,498.6285705566406,2,74949,basketball
10,74999,184,655.5208129882812,451.6666564941406,2,75183,basketball
10,75383,283,590.4166870117188,407.77777099609375,2,75666,basketball
10,75816,150,550.125,171.6999969482422,2,75966,basketball
10,75983,250,410.078125,168.9375,2,76233,basketball
10,76367,283,376.9444580078125,54.38888931274414,2,76650,basketball
10,76700,167,447.3863525390625,82.54545593261719,2,76867,basketball
10,76883,484,540.3333129882812,74.9000015258789,2,77367,basketball
10,77384,183,401.25,94.33333587646484,2,77567,basketball
10,77684,267,468.38235473632807,241.9411773681641,2,77951,basketball
10,77967,684,450.59524536132807,204.61904907226562,2,78651,basketball
10,78684,184,580.2083129882812,228.0833282470703,2,78868,basketball
10,79084,317,499.5,803.2999877929686,2,79401,basketball
10,79568,183,675.0,787.75,2,79751,basketball
10,80085,433,426.75924682617193,782.8148193359375,2,80518,basketball
10,80535,267,500.0,752.3529663085938,2,80802,basketball
10,80835,300,579.0789184570312,540.8947143554689,2,81135,basketball
10,81702,417,553.4615478515625,514.0384521484375,2,82119,basketball
10,82169,317,478.1875,389.8999938964844,2,82486,basketball
10,82503,266,512.7205810546875,338.941162109375,2,82769,basketball
10,82803,300,723.2236938476561,309.368408203125,2,83103,basketball
10,83153,367,463.75,200.2608642578125,2,83520,basketball
10,83886,351,362.32955932617193,87.7727279663086,2,84237,basketball
10,84270,283,442.3611145019531,94.27777862548828,2,84553,basketball
10,84570,384,518.9583129882812,88.375,2,84954,basketball
10,85004,250,585.078125,89.75,2,85254,basketball
10,85270,234,544.0833129882812,86.0,2,85504,basketball
10,85521,233,406.0,89.93333435058595,2,85754,basketball
10,85804,167,565.6818237304688,97.90908813476562,2,85971,basketball
10,86121,317,490.1875,187.25,2,86438,basketball
10,86454,184,460.1041564941406,174.5833282470703,2,86638,basketball
10,86721,167,418.06817626953125,228.0,2,86888,basketball
10,86921,167,399.7727355957031,163.72727966308594,2,87088,basketball
10,87105,350,491.5340881347656,150.5,2,87455,basketball
10,87471,301,475.26315307617193,217.84210205078125,2,87772,basketball
10,87788,217,434.0178527832031,214.85714721679688,2,88005,basketball
10,88055,183,513.9583129882812,221.6666717529297,2,88238,basketball
10,88255,267,580.441162109375,220.2941131591797,2,88522,basketball
10,88538,367,422.0108642578125,201.9130401611328,2,88905,basketball
10,88922,383,432.2395935058594,95.25,2,89305,basketball
10,89439,533,461.81817626953125,398.06060791015625,2,89972,basketball
10,95341,267,539.8529663085938,496.058837890625,2,95608,basketball
10,95642,266,507.7941284179688,421.23529052734375,2,95908,basketball
10,95925,200,483.75,399.75,2,96125,basketball
10,96425,200,566.0576782226562,431.23077392578125,2,96625,basketball
10,96675,367,504.45651245117193,370.478271484375,2,97042,basketball
10,97226,300,481.381591796875,402.26315307617193,2,97526,basketball
10,97559,367,625.4891357421875,511.0,2,97926,basketball
10,97943,300,604.6052856445312,503.368408203125,2,98243,basketball
10,98259,451,536.9196166992189,492.96429443359375,2,98710,basketball
10,98843,284,473.2638854980469,94.05555725097656,2,99127,basketball
10,99260,350,551.647705078125,74.86363983154298,2,99610,basketball
10,99644,233,428.8333435058594,82.46666717529298,2,99877,basketball
10,99943,401,496.0,198.55999755859372,2,100344,basketball
10,100361,250,463.046875,195.6875,2,100611,basketball
10,100627,184,565.9375,220.0833282470703,2,100811,basketball
10,100911,217,640.2678833007812,171.57142639160156,2,101128,basketball
10,101144,333,468.75,164.1904754638672,2,101477,basketball
10,101561,383,529.5833129882812,83.625,2,101944,basketball
10,102194,200,642.8846435546875,380.15383911132807,2,102394,basketball
10,102445,183,710.9375,372.25,2,102628,basketball
10,102762,500,554.3548583984375,323.2257995605469,2,103262,basketball
10,103295,434,766.9444580078125,322.8888854980469,2,103729,basketball
10,104012,200,620.673095703125,532.3076782226562,2,104212,basketball
10,104329,650,703.75,505.75,2,104979,basketball
10,104996,433,396.25,395.48147583007807,2,105429,basketball
10,105446,284,546.388916015625,489.3333435058594,2,105730,basketball
10,105946,334,745.4166870117188,502.0,2,106280,basketball
10,106330,383,538.0729370117189,450.2916564941406,2,106713,basketball
10,106897,750,631.0869750976562,488.9347839355469,2,107647,basketball
10,107663,1434,736.7291870117188,505.2614440917969,2,109097,basketball
10,109214,384,496.9270935058594,462.8333435058594,2,109598,basketball
10,109664,217,570.2678833007812,467.3571472167969,2,109881,basketball
10,109914,167,699.772705078125,492.45455932617193,2,110081,basketball
10,110265,166,549.0908813476562,498.1818237304688,2,110431,basketball
10,110448,233,560.75,475.86666870117193,2,110681,basketball
10,110698,301,527.5,468.84210205078125,2,110999,basketball
10,111032,350,539.147705078125,547.1363525390625,2,111382,basketball
10,111398,317,591.6875,536.2999877929689,2,111715,basketball
10,111765,184,570.2083129882812,605.3333129882812,2,111949,basketball
10,111999,267,471.3235168457031,605.6470336914064,2,112266,basketball
10,112549,167,617.727294921875,578.5454711914064,2,112716,basketball
10,113333,216,472.7678527832031,344.0,2,113549,basketball
10,113649,167,590.3408813476562,336.6363525390625,2,113816,basketball
10,113866,167,517.8408813476562,562.9091186523438,2,114033,basketball
10,114066,217,633.4821166992188,622.7142944335938,2,114283,basketball
10,114566,251,542.265625,526.75,2,114817,basketball
10,115317,150,503.375,404.3999938964844,2,115467,basketball
10,115667,233,464.6666564941406,370.0666809082031,2,115900,basketball
10,115950,284,684.375,374.0555419921875,2,116234,basketball
10,116284,250,813.203125,359.875,2,116534,basketball
10,116601,267,438.5294189453125,772.058837890625,2,116868,basketball
10,116934,284,280.4861145019531,532.6666870117189,2,117218,basketball
10,117234,317,550.1875,764.5999755859375,2,117551,basketball
10,117601,183,660.4166870117188,790.3333129882812,2,117784,basketball
10,117951,250,553.984375,435.3125,2,118201,basketball
10,118235,267,565.0735473632812,795.5294189453125,2,118502,basketball
10,118518,150,595.0,820.2000122070312,2,118668,basketball
10,118685,200,683.4615478515625,836.923095703125,2,118885,basketball
10,119085,184,434.4791564941406,916.0,2,119269,basketball
10,119452,167,546.9318237304689,307.9090881347656,2,119619,basketball
10,119635,184,555.4166870117189,221.25,2,119819,basketball
10,119835,167,443.75,196.5454559326172,2,120002,basketball
10,125088,250,595.078125,538.8125,2,125338,basketball
10,125722,233,622.5833129882812,463.0666809082031,2,125955,basketball
10,125971,234,716.9166870117188,499.0,2,126205,basketball
10,126222,283,545.5555419921875,493.0555419921875,2,126505,basketball
10,126672,233,496.0833435058594,454.9333190917969,2,126905,basketball
10,126939,517,565.46875,464.375,2,127456,basketball
10,127472,200,704.7115478515625,490.5384521484375,2,127672,basketball
10,127722,450,532.9910888671875,464.3928527832031,2,128172,basketball
10,128189,167,489.31817626953125,478.7272644042969,2,128356,basketball
10,128372,201,447.2115478515625,470.7692260742188,2,128573,basketball
10,128623,267,477.2794189453125,419.8235168457031,2,128890,basketball
10,128923,250,561.953125,425.6875,2,129173,basketball
10,129457,199,607.6923217773438,415.4615478515625,2,129656,basketball
10,129673,200,568.9423217773438,417.84616088867193,2,129873,basketball
10,129906,468,535.7327880859375,818.9310302734375,2,130374,basketball
10,130390,350,444.4318237304688,802.4091186523436,2,130740,basketball
10,130757,400,586.5999755859375,801.8800048828125,2,131157,basketball
10,131207,217,680.1785888671875,800.7857055664062,2,131424,basketball
10,131440,151,738.75,803.7000122070312,2,131591,basketball
10,131857,351,558.4658813476562,835.9545288085938,2,132208,basketball
10,132258,467,661.0775756835938,855.586181640625,2,132725,basketball
10,132775,183,423.3333435058594,917.1666870117188,2,132958,basketball
10,132974,151,-200.0,0.0,2,133125,basketball
10,133191,434,426.5740661621094,811.7036743164062,2,133625,basketball
10,133858,301,546.8421020507812,829.73681640625,2,134159,basketball
10,134458,367,358.80682373046875,801.4545288085938,2,134825,basketball
10,134842,634,371.7295837402344,848.2680053710938,2,135476,basketball
10,135726,350,420.9659118652344,838.6818237304686,2,136076,basketball
10,136126,283,494.375,837.0,2,136409,basketball
10,136426,250,610.703125,839.1875,2,136676,basketball
10,136693,150,-200.0,0.0,2,136843,basketball
10,137010,166,504.7727355957031,828.3636474609375,2,137176,basketball
10,137226,484,421.7916564941406,824.566650390625,2,137710,basketball
10,137793,284,475.7638854980469,829.2777709960938,2,138077,basketball
10,138094,150,450.75,826.0,2,138244,basketball
10,138510,350,529.375,836.0908813476561,2,138860,basketball
10,139061,250,666.171875,847.0625,2,139311,basketball
10,139361,633,590.80126953125,841.0,2,139994,basketball
10,140044,367,674.3478393554688,843.7825927734375,2,140411,basketball
10,140928,550,648.75,202.6764678955078,2,141478,basketball
10,141495,300,694.868408203125,197.4736785888672,2,141795,basketball
10,141845,483,769.4166870117188,193.63333129882812,2,142328,basketball
10,142345,334,814.1666870117188,199.42857360839844,2,142679,basketball
10,142695,167,850.7954711914062,196.0,2,142862,basketball
10,142879,433,886.6666870117188,207.85185241699216,2,143312,basketball
10,143329,200,934.5192260742189,208.61538696289062,2,143529,basketball
10,143696,350,665.9091186523438,838.5,2,144046,basketball
10,144063,166,714.772705078125,852.4545288085938,2,144229,basketball
10,144263,150,-200.0,0.0,2,144413,basketball
10,144463,200,614.423095703125,849.3846435546875,2,144663,basketball
10,144680,366,561.8478393554689,849.7825927734375,2,145046,basketball
10,145063,150,532.75,872.2999877929686,2,145213,basketball
10,145230,834,454.5656127929688,869.7565307617188,2,146064,basketball
10,146080,350,422.95455932617193,842.0454711914062,2,146430,basketball
10,146447,350,499.4318237304688,869.9091186523436,2,146797,basketball
10,146814,200,536.5384521484375,872.1538696289062,2,147014,basketball
10,147047,684,473.21429443359375,843.9285888671875,2,147731,basketball
10,148064,367,424.83694458007807,835.2608642578125,2,148431,basketball
10,148448,150,471.75,838.5,2,148598,basketball
10,148615,483,501.2916564941406,867.7333374023436,2,149098,basketball
10,149115,517,448.5546875,835.875,2,149632,basketball
10,149682,183,509.8958435058594,862.0833129882812,2,149865,basketball
10,155201,217,407.4107055664063,768.7857055664062,2,155418,basketball
10,155434,150,546.0,901.0999755859376,2,155584,basketball
10,155634,250,631.25,900.875,2,155884,basketball
10,156051,467,519.7413940429689,822.586181640625,2,156518,basketball
10,156551,334,452.0238037109375,810.5238037109375,2,156885,basketball
10,157418,167,649.3181762695312,211.0,2,157585,basketball
10,157769,266,498.9705810546875,441.23529052734375,2,158035,basketball
10,158085,367,549.1304321289064,540.7391357421875,2,158452,basketball
10,158469,167,517.1591186523438,558.0,2,158636,basketball
10,158652,317,691.8125,542.0999755859375,2,158969,basketball
10,159136,300,579.01318359375,613.368408203125,2,159436,basketball
10,159486,350,535.7386474609375,541.1363525390625,2,159836,basketball
10,159920,283,496.4583435058594,469.2222290039063,2,160203,basketball
10,160220,217,531.6071166992189,479.9285583496094,2,160437,basketball
10,160470,250,735.9375,340.875,2,160720,basketball
10,160770,150,630.125,318.70001220703125,2,160920,basketball
10,160953,150,662.25,154.1999969482422,2,161103,basketball
10,161303,251,527.5,533.6875,2,161554,basketball
10,161570,334,494.7619018554688,524.4285888671875,2,161904,basketball
10,161937,167,500.56817626953125,560.1818237304689,2,162104,basketball
10,162137,250,541.171875,596.75,2,162387,basketball
10,162604,667,511.0670776367188,533.5365600585938,2,163271,basketball
10,163438,283,524.1666870117189,500.6666564941406,2,163721,basketball
10,163738,584,665.2083129882812,509.6666564941406,2,164322,basketball
10,164338,384,506.3020935058594,476.125,2,164722,basketball
10,165005,217,521.7857055664064,438.4285583496094,2,165222,basketball
10,165272,334,168.8095245361328,345.8571472167969,2,165606,basketball
10,165822,367,513.6412963867189,515.8695678710938,2,166189,basketball
